STEAMbot	KEYWORD1
sb	KEYWORD1
sbBt	KEYWORD1
sbDigitalInput	KEYWORD1
sbTimer	KEYWORD1
sbRGB	KEYWORD1

state	KEYWORD2
runButton	KEYWORD2
stopButton	KEYWORD2
rgb	KEYWORD2
color_t	KEYWORD2
speaker	KEYWORD2
motors	KEYWORD2
ultrasonic	KEYWORD2
on	KEYWORD2
off	KEYWORD2
toggle	KEYWORD2
debounceDelay	KEYWORD2
setColor	KEYWORD2
setOnColor	KEYWORD2
setOffColor	KEYWORD2
nextColor	KEYWORD2
color	KEYWORD2
onColor	KEYWORD2
offColor	KEYWORD2
playNote	KEYWORD2
tone	KEYWORD2
beep	KEYWORD2
run	KEYWORD2
stop	KEYWORD2
setDelay	KEYWORD2
inches	KEYWORD2
centimeters	KEYWORD2
timedOut	KEYWORD2
isActive	KEYWORD2
remainingMs	KEYWORD2

black	LITERAL1
blue	LITERAL1
green	LITERAL1
aqua	LITERAL1
red	LITERAL1
fuchsia	LITERAL1
yellow	LITERAL1
white	LITERAL1
